1111111111111111111111
1P000000000000000000C1
1001111111C00011000001
100000000C110000110001
1000011111000000110001
10011C0000000000110001
1000011111110000110001
1C000000000C00000000E1
1111111111111111111111
