111111
1CCCC1
1CCCC1
1PCCE1
111111