111111
1CV0E1
1C0CC1
1PCC01
111111