1111111111111
100100P0100C1
1000011111001
1000111000001
1111111111111
